SO ./path_to_the_south_texture
WE ./path_to_the_west_texture
EA ./path_to_the_east_texture
NO ./path_to_the_north_texture

F 220    ,   100  ,0
C 225,30,0





1111111111111111111111111
1000000000110000000000001
1011000001010000000000001
1001000000000000000000001
1111111110110000011100001
1000000000110000000001111
1111011111111011100000011
1111011111E111011101010011111
1100000011010101011000000
1000000000000000110000011
1000000000000001101010011
1100000111000000101011111
1111011111101011011110101
1111111111111111111111111
1111111111111011111111111
1111111111111111111101111