SO ./path_to_the_south_texture
WE ./path_to_the_west_texture
EA ./path_to_the_east_texture
NO ./path_to_the_north_texture

        F 220    ,   100  ,0
    C 225,30,0





1111111111111111111111111
1000000000000000000000001
10000000000000010000000001
10000000100000000000100001
1000000000000000000000001
100000000100000000010000001
100001000000001000000000001
100000000N0000000000000001
10000000000000100000001001
1111111111111111111111111