SO ./path_to_the_south_texture
WE ./path_to_the_west_texture
EA ./path_to_the_east_texture
NO ./path_to_the_north_texture

F 220    ,   100  ,0
C 225,30,0





1111111111111111111111111
1000000000110000000000001
1011000001110000000000001
1001000000000000000000001
1111111110110000011100001
1000000000110000011101111
1111011111111011100000011
1111011111111101110101001
1100000       011010101011000001
10000N0000 000000110000001
10000000      00000001101010011
11000001      11010101111101111
1111011111101011011110101
11111111111         11111111111111
1111111111111111111111111