SO ./SRC/img/acacia.xpm
WE ./SRC/img/birch.xpm
EA ./SRC/img/bois.xpm
NO ./SRC/img/dark_wood.xpm

F 143,0,255
C 255,255,0


111111111111111111111
100000000000000000001
100000010001000001111
100000011000000000001
10000000000000000001
1000000000000N001
111111111111111111111