SO ./SRC/img/acacia.xpm
WE ./SRC/img/birch.xpm
EA ./SRC/img/bois.xpm
NO ./SRC/img/DOES_NOT_EXIST.xpm

F 220,100,0
C 225,30,0

11111
10N01
11111