SO ./SRC/img/acacia.xpm
WE ./SRC/img/birch.xpm
EA ./SRC/img/bois.xpm
NO ./SRC/img/dark_wood.xpm

F 220,100,0
C 225,30,0

11111
10N01
10S01
11111